     #########
     #*.*#*.*#
     #.*.*.*.#
     #*.*.*.*#
     #.*.*.*.#
     #*.*.*.*#
     ###   ###
       #   #
   ###### ######
   #           #
   # $ $ $ $ $ #
   ## $ $ $ $ ##
    #$ $ $ $ $#
    #   $@$   #
    #  #####  #
    ####   ####