
         ####
         #  ##
         #   ##
         # $$ ##
       ###$  $ ##
    ####    $   #
  ###  # #####  #
  #    # #....$ #
  # #   $ ....# #
  #  $ # #.*..# #
  ###  #### ### #
    #### @$  ##$##
       ### $     #
         #  ##   #
         #########