
#####
#   ##
# $  #########
## # #       ######
## #   $#$#@  #   #
#  #      $ #   $ #
#  ### ######### ##
#  ## ..*..... # ##
## ## *.*..*.* # ##
# $########## ##$ #
#  $   $  $    $  #
#  #   #   #   #  #
###################