
          ####
     #### #  #
   ###  ###$ #
  ##   @  $  #
 ##  $ $$## ##
 #  #$##     #
 # # $ $$ # ###
 #   $ #  # $ #####
####    #  $$ #   #
#### ## $         #
#.    ###  ########
#.. ..# ####
#...#.#
#.....#
#######