
     ###########
     #  .  #   #
     # #.    @ #
 ##### ##..# ####
##  # ..###     ###
# $ #...   $ #  $ #
#    .. ##  ## ## #
####$##$# $ #   # #
  ## #    #$ $$ # #
  #  $ # #  # $## #
  #               #
  #  ###########  #
  ####         ####