
   #########
  ##   ##  #####
###     #  #    ###
#  $ #$ #  #  ... #
# # $#@$## # #.#. #
#  # #$  #    . . #
# $    $ # # #.#. #
#   ##  ##$ $ . . #
# $ #   #  #$#.#. #
## $  $   $  $... #
 #$ ######    ##  #
 #  #    ##########
 ####