
      ########
   ####      ######
   #    ## $ $   @#
   # ## ##$#$ $ $##
 ### ......#  $$ ##
 #   ......#  #   #
 # # ......#$  $  #
 # # ...... $$# $ #
 #  $### ###$  $ ##
 ###  $  $  $  $ #
   #   $ $  $  $ #
   ######   ######
        #####