

 ################
 #              #
 # # ######     #
 # #  $ $ $ $#  #
 # #   $@$   ## ##
 # # #$ $ $###...#
 # #   $ $  ##...#
 # ###$$$ $ ##...#
 #     # ## ##...#
 #####   ## ##...#
     #####     ###
         #     #
         #######