    ####
    #  ###########
    #    $   $ $ #
    # $# $ #  $  #
    #  $ $  #    #
  ### $# #  #### #
  #@#$ $ $  ##   #
  #    $ #$#   # #
  #   $    $ $ $ #
   ####  #########
    #      #
    #      #
    #......#
    #......#
    #......#
    ########